############
####          P   ###
#########   X     ###
############ O    ###
#####################
